###E##
### #
##  #
## ##
##S##